7
6
2 1 3 2 4 3
1 1 0 2 3 2
2 1 1 3 2 1
3 2 4 2 1 2
2 3 3 1 1 3
1 2 1 2 1 2
2 1 2 4 2 1