7
6
2 3 2 1 4 1
1 2 0 2 3 2
2 1 1 3 2 3
3 2 4 1 1 2
1 3 3 2 1 1
2 1 2 1 2 3
3 2 1 4 1 2