15
15
1 2 3 1 2 3 1 2 3 1 2 3 1 2 3
2 1 2 3 1 2 3 1 2 3 1 2 3 1 2
3 2 1 2 3 1 2 3 1 2 3 1 2 3 1
1 3 2 1 2 3 1 2 3 1 2 0 1 2 3
2 1 3 2 4 2 3 1 2 3 1 2 3 1 2
3 2 1 3 2 1 2 3 1 2 3 1 2 3 1
1 3 2 1 3 2 1 2 3 1 2 3 1 2 3
2 1 3 2 1 3 2 1 2 3 1 2 3 1 2
3 2 1 3 2 1 3 2 1 2 3 1 2 3 1
1 3 2 1 3 2 1 3 2 1 2 3 1 2 3
2 1 3 2 1 3 2 1 3 2 1 2 3 1 2
3 2 1 3 2 1 3 2 1 3 2 1 2 3 1
1 3 2 1 3 2 1 3 2 1 3 2 1 2 3
2 1 3 2 1 3 2 1 3 2 1 3 2 4 2
3 2 1 3 2 1 3 2 1 3 2 1 3 2 1